,index,Gene,StartNT,EndNT,NTWindowSize,SumMutationCount,MeanCount,MeanCountSquared
0,301,TP53,722,869,147,484,3.43262411348,11.7829083044
1,300,TP53,722,869,147,487,3.42957746479,11.762001587
2,299,TP53,721,865,144,487,3.42957746479,11.762001587
3,302,TP53,722,869,147,479,3.42142857143,11.7061734694
4,298,TP53,721,865,144,488,3.41258741259,11.6457528486
5,284,TP53,706,854,148,491,3.40972222222,11.6262056327
6,285,TP53,707,856,149,497,3.40410958904,11.5879620942
7,297,TP53,721,865,144,489,3.39583333333,11.5316840278
8,322,TP53,742,881,139,441,3.39230769231,11.5077514793
9,296,TP53,720,865,145,490,3.37931034483,11.4197384067
10,295,TP53,719,863,144,490,3.37931034483,11.4197384067
11,283,TP53,704,853,149,483,3.37762237762,11.4083329258
12,321,TP53,741,881,140,442,3.37404580153,11.3841850708
13,293,TP53,716,863,147,495,3.36734693878,11.3390254061
14,294,TP53,718,863,145,491,3.36301369863,11.3098611372
15,303,TP53,722,869,147,467,3.35971223022,11.2876662699
16,291,TP53,715,862,147,497,3.35810810811,11.2768900657
17,286,TP53,709,857,148,497,3.35810810811,11.2768900657
18,320,TP53,740,881,141,443,3.35606060606,11.2631427916
19,292,TP53,716,863,147,496,3.35135135135,11.2315558802
20,290,TP53,714,862,148,498,3.34228187919,11.17084816
21,287,TP53,711,859,148,498,3.34228187919,11.17084816
22,319,TP53,739,881,142,444,3.33834586466,11.1445531121
23,288,TP53,713,861,148,500,3.33333333333,11.1111111111
24,289,TP53,714,862,148,499,3.32666666667,11.0667111111
25,307,TP53,730,874,144,469,3.32624113475,11.0638800865
26,305,TP53,725,874,149,472,3.32394366197,11.048601468
27,306,TP53,730,874,144,472,3.32394366197,11.048601468
28,304,TP53,725,874,149,475,3.32167832168,11.0335468727
29,318,TP53,738,881,143,445,3.32089552239,11.0283470706
30,308,TP53,731,880,149,471,3.31690140845,11.0018349534
31,310,TP53,733,881,148,470,3.30985915493,10.9551676255
32,311,TP53,733,881,148,466,3.30496453901,10.9227906041
33,317,TP53,738,881,143,446,3.3037037037,10.9144581619
34,316,TP53,736,881,145,448,3.29411764706,10.8512110727
35,309,TP53,733,881,148,471,3.29370629371,10.8485011492
36,315,TP53,736,881,145,449,3.27737226277,10.7411689488
37,314,TP53,734,881,147,451,3.26811594203,10.6805818105
38,313,TP53,734,881,147,453,3.25899280576,10.621034108
39,312,TP53,734,881,147,454,3.24285714286,10.516122449
40,323,TP53,743,881,138,421,3.23846153846,10.4876331361
41,282,TP53,701,848,147,445,3.15602836879,9.96051506463
42,279,TP53,697,845,148,437,3.14388489209,9.88401221469
43,281,TP53,700,848,148,446,3.14084507042,9.8649077564
44,278,TP53,697,845,148,438,3.12857142857,9.78795918367
45,280,TP53,698,847,149,441,3.12765957447,9.78225441376
46,373,TP53,811,960,149,325,3.125,9.765625
47,371,TP53,810,957,147,325,3.125,9.765625
48,277,TP53,697,845,148,440,3.12056737589,9.73794074745
49,372,TP53,811,960,149,326,3.10476190476,9.63954648526
50,370,TP53,810,957,147,326,3.10476190476,9.63954648526
51,276,TP53,693,841,148,423,3.08759124088,9.53321967073
52,369,TP53,809,957,148,327,3.08490566038,9.51664293343
53,368,TP53,808,955,147,327,3.08490566038,9.51664293343
54,367,TP53,807,950,143,327,3.08490566038,9.51664293343
55,275,TP53,693,841,148,425,3.07971014493,9.48461457677
56,407,TP53,839,976,137,233,3.06578947368,9.39906509695
57,365,TP53,805,949,144,328,3.06542056075,9.39680321425
58,366,TP53,806,950,144,328,3.06542056075,9.39680321425
59,359,TP53,796,936,140,336,3.05454545455,9.33024793388
60,355,TP53,785,919,134,339,3.05405405405,9.32724616508
61,356,TP53,790,935,145,342,3.05357142857,9.32429846939
62,406,TP53,838,976,138,235,3.05194805195,9.31438691179
63,364,TP53,802,949,147,329,3.0462962963,9.27992112483
64,360,TP53,797,936,139,332,3.04587155963,9.27733355778
65,358,TP53,795,936,141,337,3.03603603604,9.21751481211
66,357,TP53,793,935,142,337,3.03603603604,9.21751481211
67,354,TP53,784,919,135,340,3.03571428571,9.21556122449
68,378,TP53,817,960,143,300,3.0303030303,9.18273645546
69,363,TP53,800,948,148,327,3.02777777778,9.1674382716
70,404,TP53,837,974,137,236,3.02564102564,9.15450361604
71,405,TP53,838,976,138,236,3.02564102564,9.15450361604
72,377,TP53,817,960,143,302,3.02,9.1204
73,353,TP53,784,919,135,341,3.01769911504,9.10650794894
74,350,TP53,783,919,136,350,3.01724137931,9.10374554102
75,332,TP53,747,892,145,368,3.01639344262,9.0986294007
76,376,TP53,814,960,146,304,3.0099009901,9.0595039702
77,362,TP53,800,948,148,328,3.00917431193,9.05513003956
78,352,TP53,783,919,136,343,3.00877192982,9.0527085257
79,331,TP53,747,892,145,370,3.0081300813,9.04884658603
80,403,TP53,836,974,138,237,3.0,9.0
81,349,TP53,783,919,136,351,3.0,9.0
82,330,TP53,746,892,146,371,2.99193548387,8.95167793965
83,351,TP53,783,919,136,344,2.99130434783,8.94790170132
84,361,TP53,800,948,148,329,2.99090909091,8.94553719008
85,374,TP53,812,960,148,308,2.99029126214,8.94184183241
86,375,TP53,813,960,147,305,2.99019607843,8.94127258747
87,401,TP53,836,974,138,242,2.98765432099,8.92607834172
88,402,TP53,836,974,138,239,2.9875,8.92515625
89,333,TP53,751,898,147,367,2.9837398374,8.90270341728
90,348,TP53,782,919,137,352,2.98305084746,8.89859235852
91,324,TP53,743,881,138,384,2.97674418605,8.86100594916
92,329,TP53,746,892,146,372,2.976,8.856576
93,334,TP53,753,900,147,366,2.9756097561,8.85425342058
94,325,TP53,743,881,138,380,2.96875,8.8134765625
95,326,TP53,745,892,147,380,2.96875,8.8134765625
96,347,TP53,782,919,137,353,2.96638655462,8.79944919144
97,400,TP53,835,974,139,243,2.96341463415,8.78182629387
98,328,TP53,745,892,147,373,2.96031746032,8.76347946586
99,337,TP53,766,913,147,370,2.96,8.7616
100,327,TP53,745,892,147,375,2.95275590551,8.71876743753
101,346,TP53,781,919,138,354,2.95,8.7025
102,380,TP53,818,960,142,286,2.94845360825,8.69337867999
103,336,TP53,764,911,147,368,2.944,8.667136
104,335,TP53,763,908,145,368,2.944,8.667136
105,399,TP53,835,974,139,244,2.93975903614,8.64218319059
106,268,TP53,670,818,148,335,2.93859649123,8.63534933826
107,345,TP53,779,919,140,355,2.93388429752,8.60767707124
108,379,TP53,817,960,143,287,2.92857142857,8.57653061224
109,338,TP53,772,919,147,374,2.921875,8.53735351562
110,267,TP53,670,818,148,336,2.92173913043,8.53655954631
111,344,TP53,777,919,142,356,2.91803278689,8.51491534534
112,398,TP53,832,974,142,245,2.91666666667,8.50694444444
113,244,TP53,614,753,139,265,2.91208791209,8.48025600773
114,243,TP53,613,751,138,265,2.91208791209,8.48025600773
115,343,TP53,776,919,143,358,2.91056910569,8.471412519
116,342,TP53,775,919,144,359,2.89516129032,8.38195889698
117,246,TP53,625,773,148,275,2.89473684211,8.37950138504
118,397,TP53,832,974,142,246,2.89411764706,8.37591695502
119,242,TP53,612,751,139,266,2.89130434783,8.35964083176
120,341,TP53,774,919,145,361,2.888,8.340544
121,339,TP53,772,919,147,366,2.88188976378,8.30528861058
122,241,TP53,610,751,141,268,2.88172043011,8.3043126373
123,340,TP53,773,919,146,362,2.87301587302,8.2542202066
124,269,TP53,673,822,149,339,2.87288135593,8.25344728526
125,396,TP53,831,974,143,247,2.87209302326,8.24891833423
126,240,TP53,609,751,142,269,2.86170212766,8.18933906745
127,236,TP53,596,745,149,263,2.85869565217,8.17214083176
128,247,TP53,627,775,148,274,2.85416666667,8.14626736111
129,395,TP53,831,974,143,248,2.85057471264,8.12577619236
130,245,TP53,619,764,145,262,2.84782608696,8.11011342155
131,239,TP53,607,751,144,270,2.84210526316,8.07756232687
132,394,TP53,830,974,144,250,2.84090909091,8.07076446281
133,408,TP53,839,976,137,213,2.84,8.0656
134,270,TP53,678,826,148,345,2.82786885246,7.99684224671
135,248,TP53,632,779,147,277,2.82653061224,7.98927530196
136,238,TP53,604,751,147,271,2.82291666667,7.96885850694
137,235,TP53,595,743,148,254,2.82222222222,7.9649382716
138,393,TP53,830,974,144,251,2.8202247191,7.95366746623
139,387,TP53,822,960,138,253,2.81111111111,7.90234567901
140,237,TP53,599,747,148,267,2.81052631579,7.89905817175
141,389,TP53,824,973,149,252,2.8,7.84
142,391,TP53,826,974,148,252,2.8,7.84
143,392,TP53,827,974,147,252,2.8,7.84
144,388,TP53,824,973,149,254,2.79120879121,7.79084651612
145,386,TP53,822,960,138,254,2.79120879121,7.79084651612
146,381,TP53,818,960,142,267,2.78125,7.7353515625
147,390,TP53,826,974,148,253,2.78021978022,7.72962202633
148,272,TP53,685,832,147,350,2.77777777778,7.71604938272
149,385,TP53,821,960,139,255,2.77173913043,7.68253780718
150,271,TP53,684,832,148,351,2.76377952756,7.63847727695
151,384,TP53,820,960,140,256,2.75268817204,7.57729217251
152,273,TP53,687,836,149,357,2.74615384615,7.54136094675
153,249,TP53,637,784,147,291,2.74528301887,7.53657885368
154,262,TP53,654,800,146,279,2.73529411765,7.48183391003
155,261,TP53,652,800,148,279,2.73529411765,7.48183391003
156,383,TP53,820,960,140,257,2.73404255319,7.47498868266
157,274,TP53,689,838,149,359,2.7196969697,7.39675160698
158,260,TP53,652,800,148,280,2.71844660194,7.38995192761
159,382,TP53,819,960,141,258,2.71578947368,7.37551246537
160,251,TP53,638,784,146,282,2.71153846154,7.3524408284
161,264,TP53,659,807,148,281,2.70192307692,7.30038831361
162,263,TP53,658,806,148,281,2.70192307692,7.30038831361
163,259,TP53,651,800,149,281,2.70192307692,7.30038831361
164,257,TP53,645,790,145,270,2.7,7.29
165,252,TP53,638,784,146,278,2.69902912621,7.28475822415
166,250,TP53,637,784,147,283,2.69523809524,7.26430839002
167,253,TP53,640,784,144,274,2.6862745098,7.21607074202
168,256,TP53,645,790,145,271,2.68316831683,7.19939221645
169,258,TP53,647,795,148,271,2.68316831683,7.19939221645
170,254,TP53,641,785,144,273,2.67647058824,7.16349480969
171,266,TP53,665,813,148,291,2.64545454545,6.99842975207
172,265,TP53,664,812,148,291,2.64545454545,6.99842975207
173,255,TP53,643,785,142,267,2.64356435644,6.98843250662
174,409,TP53,840,976,136,182,2.45945945946,6.04894083272
175,415,TP53,844,991,147,172,2.45714285714,6.03755102041
176,410,TP53,840,976,136,179,2.45205479452,6.01257271533
177,416,TP53,844,991,147,169,2.44927536232,5.99894980046
178,411,TP53,841,976,135,175,2.43055555556,5.90760030864
179,412,TP53,841,976,135,171,2.40845070423,5.80063479468
180,413,TP53,841,976,135,168,2.4,5.76
181,414,TP53,843,987,144,168,2.4,5.76
182,181,TP53,520,664,144,201,2.36470588235,5.59183391003
183,183,TP53,523,670,147,201,2.36470588235,5.59183391003
184,422,TP53,848,993,145,151,2.359375,5.56665039062
185,184,TP53,524,670,146,200,2.35294117647,5.53633217993
186,182,TP53,521,670,149,202,2.3488372093,5.5170362358
187,180,TP53,517,664,147,202,2.3488372093,5.5170362358
188,420,TP53,847,993,146,155,2.34848484848,5.51538108356
189,421,TP53,847,993,146,152,2.33846153846,5.46840236686
190,419,TP53,847,993,146,156,2.32835820896,5.42125194921
191,229,TP53,586,734,148,197,2.31764705882,5.37148788927
192,423,TP53,848,993,145,146,2.31746031746,5.370622323
193,418,TP53,845,993,148,157,2.30882352941,5.33066608997
194,424,TP53,853,993,140,143,2.3064516129,5.31971904266
195,417,TP53,845,993,148,158,2.28985507246,5.24343625289
196,230,TP53,587,736,149,194,2.25581395349,5.08869659275
197,167,TP53,488,637,149,187,2.25301204819,5.0760632893
198,231,TP53,589,738,149,196,2.25287356322,5.07543929185
199,234,TP53,592,740,148,196,2.25287356322,5.07543929185
200,232,TP53,590,738,148,196,2.25287356322,5.07543929185
201,173,TP53,497,645,148,189,2.25,5.0625
202,220,TP53,574,722,148,186,2.24096385542,5.02191900131
203,233,TP53,592,740,148,197,2.23863636364,5.0114927686
204,174,TP53,499,645,146,188,2.2380952381,5.00907029478
205,219,TP53,574,722,148,187,2.22619047619,4.95592403628
206,165,TP53,481,625,144,182,2.21951219512,4.9262343843
207,172,TP53,493,640,147,182,2.21951219512,4.9262343843
208,228,TP53,584,733,149,184,2.21686746988,4.91450137901
209,166,TP53,484,627,143,181,2.20731707317,4.87224866151
210,164,TP53,480,625,145,183,2.20481927711,4.86122804471
211,163,TP53,480,625,145,185,2.20238095238,4.85048185941
212,179,TP53,514,658,144,187,2.2,4.84
213,171,TP53,490,638,148,178,2.1975308642,4.8291418991
214,222,TP53,577,725,148,182,2.19277108434,4.80824502831
215,154,TP53,472,614,142,199,2.18681318681,4.78215191402
216,178,TP53,514,658,144,188,2.18604651163,4.778799351
217,226,TP53,581,730,149,177,2.18518518519,4.77503429355
218,175,TP53,507,652,145,190,2.18390804598,4.76945435328
219,177,TP53,511,658,147,190,2.18390804598,4.76945435328
220,221,TP53,574,722,148,179,2.18292682927,4.76516954194
221,170,TP53,490,638,148,179,2.18292682927,4.76516954194
222,223,TP53,578,725,147,179,2.18292682927,4.76516954194
223,138,TP53,454,596,142,216,2.18181818182,4.76033057851
224,169,TP53,490,638,148,181,2.18072289157,4.7555523298
225,156,TP53,473,614,141,194,2.1797752809,4.75142027522
226,160,TP53,475,614,139,185,2.17647058824,4.73702422145
227,225,TP53,580,725,145,174,2.175,4.730625
228,227,TP53,583,730,147,176,2.17283950617,4.72123151959
229,139,TP53,455,599,144,215,2.17171717172,4.71635547393
230,176,TP53,511,658,147,191,2.17045454545,4.71087293388
231,137,TP53,452,596,144,217,2.17,4.7089
232,162,TP53,477,619,142,182,2.16666666667,4.69444444444
233,168,TP53,489,638,149,182,2.16666666667,4.69444444444
234,155,TP53,472,614,142,195,2.16666666667,4.69444444444
235,161,TP53,476,619,143,184,2.16470588235,4.68595155709
236,159,TP53,475,614,139,186,2.16279069767,4.67766360195
237,224,TP53,580,725,145,175,2.16049382716,4.6677335772
238,157,TP53,473,614,141,190,2.15909090909,4.66167355372
239,136,TP53,452,596,144,218,2.15841584158,4.6587589452
240,152,TP53,469,613,144,198,2.15217391304,4.63185255198
241,158,TP53,475,614,139,187,2.14942528736,4.62002906593
242,135,TP53,451,596,145,219,2.14705882353,4.6098615917
243,153,TP53,469,613,144,195,2.14285714286,4.59183673469
244,151,TP53,468,613,145,199,2.13978494624,4.57867961614
245,150,TP53,467,613,146,201,2.13829787234,4.57231779086
246,134,TP53,451,596,145,220,2.1359223301,4.56216420021
247,141,TP53,457,599,142,207,2.13402061856,4.55404400043
248,216,TP53,560,707,147,149,2.12857142857,4.53081632653
249,217,TP53,562,709,147,149,2.12857142857,4.53081632653
250,149,TP53,466,613,147,202,2.12631578947,4.52121883657
251,133,TP53,451,596,145,221,2.125,4.515625
252,140,TP53,456,599,143,208,2.12244897959,4.50478967097
253,147,TP53,464,612,148,203,2.11458333333,4.47146267361
254,148,TP53,466,613,147,203,2.11458333333,4.47146267361
255,142,TP53,457,599,142,203,2.11458333333,4.47146267361
256,143,TP53,459,604,145,203,2.11458333333,4.47146267361
257,132,TP53,451,596,145,222,2.11428571429,4.47020408163
258,215,TP53,560,707,147,150,2.11267605634,4.46340011902
259,130,TP53,442,589,147,215,2.10784313725,4.44300269127
260,129,TP53,442,589,147,217,2.1067961165,4.43858987652
261,128,TP53,440,587,147,217,2.1067961165,4.43858987652
262,127,TP53,439,586,147,217,2.1067961165,4.43858987652
263,126,TP53,438,586,148,219,2.10576923077,4.43426405325
264,145,TP53,462,609,147,202,2.10416666667,4.42751736111
265,146,TP53,464,612,148,204,2.10309278351,4.42299925603
266,214,TP53,560,707,147,151,2.09722222222,4.39834104938
267,131,TP53,444,592,148,216,2.09708737864,4.39777547365
268,144,TP53,461,609,148,203,2.09278350515,4.37974279945
269,218,TP53,571,719,148,163,2.08974358974,4.36702827087
270,213,TP53,560,707,147,152,2.08219178082,4.33552261212
271,124,TP53,434,581,147,214,2.07766990291,4.31671222547
272,93,TP53,396,542,146,220,2.07547169811,4.30758276967
273,187,TP53,527,670,143,170,2.07317073171,4.29803688281
274,123,TP53,431,580,149,211,2.06862745098,4.27921953095
275,125,TP53,437,584,147,215,2.06730769231,4.27376109467
276,92,TP53,396,542,146,221,2.06542056075,4.26596209276
277,186,TP53,527,670,143,171,2.06024096386,4.24459282915
278,122,TP53,431,580,149,212,2.05825242718,4.23640305401
279,91,TP53,395,542,147,222,2.05555555556,4.22530864198
280,211,TP53,559,706,147,152,2.05405405405,4.21913805698
281,185,TP53,524,670,146,172,2.04761904762,4.19274376417
282,90,TP53,394,542,148,223,2.04587155963,4.18559043852
283,212,TP53,559,706,147,149,2.04109589041,4.16607243385
284,210,TP53,559,706,147,153,2.04,4.1616
285,121,TP53,430,577,147,208,2.03921568627,4.15840061515
286,191,TP53,532,673,141,161,2.03797468354,4.15334081077
287,192,TP53,535,678,143,161,2.03797468354,4.15334081077
288,89,TP53,394,542,148,224,2.03636363636,4.1467768595
289,120,TP53,429,577,148,209,2.02912621359,4.11735319069
290,209,TP53,556,701,145,150,2.02702702703,4.1088385683
291,88,TP53,394,542,148,225,2.02702702703,4.1088385683
292,190,TP53,531,673,142,162,2.025,4.100625
293,87,TP53,394,542,148,226,2.01785714286,4.07174744898
294,84,TP53,391,538,147,228,2.01769911504,4.07110971885
295,193,TP53,536,684,148,159,2.01265822785,4.05079314212
296,188,TP53,528,670,142,163,2.01234567901,4.04953513184
297,189,TP53,529,673,144,163,2.01234567901,4.04953513184
298,119,TP53,428,574,146,207,2.00970873786,4.03892921105
299,118,TP53,427,574,147,207,2.00970873786,4.03892921105
300,117,TP53,427,574,147,209,2.00961538462,4.03855399408
301,83,TP53,389,538,149,229,2.00877192982,4.03516466605
302,194,TP53,536,684,148,156,2.0,4.0
303,86,TP53,392,538,146,222,2.0,4.0
304,82,TP53,388,536,148,223,1.99107142857,3.96436543367
305,85,TP53,391,538,147,223,1.99107142857,3.96436543367
306,115,TP53,422,562,140,205,1.99029126214,3.96125930813
307,81,TP53,388,536,148,224,1.98230088496,3.9295167985
308,113,TP53,421,560,139,206,1.98076923077,3.92344674556
309,114,TP53,422,562,140,206,1.98076923077,3.92344674556
310,196,TP53,538,685,147,152,1.97402597403,3.89677854613
311,197,TP53,538,685,147,150,1.97368421053,3.89542936288
312,80,TP53,382,529,147,217,1.97272727273,3.89165289256
313,79,TP53,380,528,148,217,1.97272727273,3.89165289256
314,95,TP53,404,550,146,217,1.97272727273,3.89165289256
315,94,TP53,398,542,144,209,1.97169811321,3.88759344963
316,112,TP53,421,560,139,207,1.97142857143,3.88653061224
317,106,TP53,409,554,145,203,1.97087378641,3.88434348195
318,116,TP53,424,562,138,201,1.97058823529,3.88321799308
319,77,TP53,379,527,148,218,1.96396396396,3.85715445175
320,78,TP53,380,528,148,218,1.96396396396,3.85715445175
321,111,TP53,420,560,140,208,1.96226415094,3.85048059808
322,105,TP53,407,554,147,204,1.96153846154,3.84763313609
323,195,TP53,538,685,147,153,1.96153846154,3.84763313609
324,96,TP53,404,550,146,213,1.95412844037,3.81861796145
325,98,TP53,404,550,146,209,1.95327102804,3.81526770897
326,110,TP53,417,560,143,209,1.95327102804,3.81526770897
327,104,TP53,407,554,147,205,1.95238095238,3.81179138322
328,202,TP53,548,697,149,150,1.94805194805,3.79490639231
329,200,TP53,546,693,147,148,1.94736842105,3.79224376731
330,198,TP53,542,687,145,148,1.94736842105,3.79224376731
331,199,TP53,542,687,145,146,1.94666666667,3.78951111111
332,109,TP53,417,560,143,210,1.94444444444,3.78086419753
333,97,TP53,404,550,146,210,1.94444444444,3.78086419753
334,102,TP53,406,554,148,206,1.94339622642,3.77678889284
335,103,TP53,407,554,147,206,1.94339622642,3.77678889284
336,201,TP53,548,697,149,151,1.9358974359,3.74769888231
337,108,TP53,415,560,145,211,1.93577981651,3.74724349802
338,101,TP53,405,554,149,207,1.93457943925,3.74259760678
339,208,TP53,554,700,146,143,1.93243243243,3.73429510592
340,107,TP53,415,560,145,212,1.92727272727,3.71438016529
341,99,TP53,405,554,149,210,1.92660550459,3.71180877031
342,100,TP53,405,554,149,208,1.92592592593,3.70919067215
343,205,TP53,550,697,147,144,1.92,3.6864
344,207,TP53,554,700,146,144,1.92,3.6864
345,75,TP53,376,524,148,211,1.91818181818,3.6794214876
346,76,TP53,378,527,149,212,1.90990990991,3.64775586397
347,74,TP53,376,524,148,212,1.90990990991,3.64775586397
348,206,TP53,554,700,146,145,1.90789473684,3.64006232687
349,204,TP53,550,697,147,145,1.90789473684,3.64006232687
350,73,TP53,376,524,148,213,1.90178571429,3.61678890306
351,203,TP53,550,697,147,146,1.8961038961,3.59520998482
352,72,TP53,375,524,149,214,1.89380530973,3.58649855118
353,71,TP53,375,524,149,215,1.88596491228,3.55686365035
354,70,TP53,375,524,149,216,1.87826086957,3.52786389414
355,67,TP53,359,499,140,186,1.72222222222,2.96604938272
356,66,TP53,358,499,141,187,1.71559633028,2.94327076845
357,65,TP53,357,497,140,185,1.69724770642,2.88064977695
358,63,TP53,350,497,147,188,1.69369369369,2.86859832806
359,64,TP53,352,497,145,186,1.69090909091,2.85917355372
360,62,TP53,343,490,147,184,1.6880733945,2.8495917852
361,68,TP53,364,511,147,183,1.67889908257,2.81870212945
362,426,TP53,853,993,140,100,1.66666666667,2.77777777778
363,69,TP53,374,521,147,189,1.65789473684,2.74861495845
364,425,TP53,853,993,140,101,1.65573770492,2.74146734749
365,61,TP53,339,484,145,173,1.6320754717,2.66367034532
366,60,TP53,339,484,145,174,1.6261682243,2.64442309372
367,56,TP53,329,476,147,172,1.62264150943,2.63296546814
368,55,TP53,329,476,147,173,1.61682242991,2.61411476985
369,59,TP53,334,480,146,170,1.60377358491,2.57208971164
370,54,TP53,324,473,149,165,1.60194174757,2.56621736262
371,58,TP53,333,480,147,171,1.59813084112,2.55402218534
372,57,TP53,332,480,148,172,1.59259259259,2.53635116598
373,53,TP53,323,472,149,161,1.57843137255,2.49144559785
374,52,TP53,321,469,148,157,1.55445544554,2.41633173218
375,51,TP53,321,469,148,158,1.54901960784,2.39946174548
376,48,TP53,314,461,147,150,1.54639175258,2.39132745244
377,429,TP53,856,993,137,88,1.54385964912,2.38350261619
378,441,TP53,869,994,125,71,1.54347826087,2.38232514178
379,47,TP53,311,457,146,148,1.54166666667,2.37673611111
380,49,TP53,315,464,149,151,1.54081632653,2.3741149521
381,437,TP53,861,994,133,77,1.54,2.3716
382,45,TP53,309,457,148,149,1.53608247423,2.35954936763
383,46,TP53,310,457,147,149,1.53608247423,2.35954936763
384,50,TP53,319,467,148,155,1.53465346535,2.3551612587
385,428,TP53,855,993,138,89,1.53448275862,2.3546373365
386,440,TP53,865,994,129,72,1.53191489362,2.34676324129
387,436,TP53,859,994,135,78,1.52941176471,2.33910034602
388,427,TP53,854,993,139,90,1.52542372881,2.32691755243
389,442,TP53,871,1006,135,70,1.52173913043,2.3156899811
390,439,TP53,863,994,131,73,1.52083333333,2.31293402778
391,435,TP53,859,994,135,79,1.51923076923,2.30806213018
392,438,TP53,862,994,132,74,1.51020408163,2.28071636818
393,434,TP53,858,994,136,80,1.50943396226,2.27839088644
394,433,TP53,857,994,137,81,1.5,2.25
395,446,TP53,874,1006,132,63,1.5,2.25
396,29,TP53,256,405,149,108,1.5,2.25
397,484,TP53,991,1123,132,21,1.5,2.25
398,444,TP53,873,1006,133,66,1.5,2.25
399,431,TP53,856,993,137,82,1.49090909091,2.22280991736
400,432,TP53,857,994,137,82,1.49090909091,2.22280991736
401,443,TP53,872,1006,134,67,1.48888888889,2.21679012346
402,445,TP53,873,1006,133,64,1.48837209302,2.21525148729
403,447,TP53,874,1006,132,61,1.48780487805,2.21356335515
404,448,TP53,877,1020,143,61,1.48780487805,2.21356335515
405,32,TP53,265,407,142,110,1.48648648649,2.20964207451
406,430,TP53,856,993,137,83,1.48214285714,2.19674744898
407,31,TP53,261,407,146,111,1.48,2.1904
408,43,TP53,300,442,142,130,1.47727272727,2.18233471074
409,42,TP53,293,442,149,130,1.47727272727,2.18233471074
410,449,TP53,880,1020,140,59,1.475,2.175625
411,30,TP53,260,407,147,112,1.47368421053,2.17174515235
412,41,TP53,289,437,148,125,1.47058823529,2.16262975779
413,38,TP53,281,429,148,122,1.46987951807,2.16054579765
414,483,TP53,987,1123,136,22,1.46666666667,2.15111111111
415,40,TP53,287,431,144,123,1.46428571429,2.14413265306
416,450,TP53,880,1020,140,57,1.46153846154,2.13609467456
417,44,TP53,302,451,149,133,1.46153846154,2.13609467456
418,39,TP53,287,431,144,124,1.45882352941,2.12816608997
419,28,TP53,253,396,143,96,1.45454545455,2.11570247934
420,33,TP53,269,417,148,112,1.45454545455,2.11570247934
421,461,TP53,913,1050,137,48,1.45454545455,2.11570247934
422,37,TP53,274,422,148,113,1.44871794872,2.09878369494
423,453,TP53,892,1031,139,55,1.44736842105,2.09487534626
424,0,TP53,91,222,131,39,1.44444444444,2.08641975309
425,34,TP53,272,421,149,114,1.44303797468,2.08235859638
426,36,TP53,273,422,149,114,1.44303797468,2.08235859638
427,460,TP53,911,1050,139,49,1.44117647059,2.07698961938
428,35,TP53,273,422,149,115,1.4375,2.06640625
429,452,TP53,881,1020,139,53,1.43243243243,2.05186267348
430,459,TP53,908,1050,142,50,1.42857142857,2.04081632653
431,458,TP53,904,1049,145,50,1.42857142857,2.04081632653
432,451,TP53,881,1020,139,54,1.42105263158,2.01939058172
433,463,TP53,916,1050,134,44,1.41935483871,2.01456815817
434,455,TP53,898,1031,133,51,1.41666666667,2.00694444444
435,457,TP53,902,1049,147,51,1.41666666667,2.00694444444
436,456,TP53,900,1036,136,51,1.41666666667,2.00694444444
437,466,TP53,920,1057,137,41,1.41379310345,1.99881093936
438,462,TP53,915,1050,135,45,1.40625,1.9775390625
439,454,TP53,894,1031,137,52,1.40540540541,1.97516435354
440,465,TP53,919,1057,138,42,1.4,1.96
441,470,TP53,948,1057,109,35,1.4,1.96
442,482,TP53,976,1101,125,21,1.4,1.96
443,1,TP53,113,260,147,42,1.4,1.96
444,464,TP53,919,1057,138,43,1.38709677419,1.92403746098
445,469,TP53,943,1057,114,36,1.38461538462,1.91715976331
446,471,TP53,949,1057,108,33,1.375,1.890625
447,481,TP53,974,1101,127,22,1.375,1.890625
448,468,TP53,936,1057,121,37,1.37037037037,1.87791495199
449,477,TP53,960,1066,106,26,1.36842105263,1.87257617729
450,3,TP53,141,287,146,52,1.36842105263,1.87257617729
451,2,TP53,137,274,137,49,1.36111111111,1.85262345679
452,467,TP53,935,1057,122,38,1.35714285714,1.84183673469
453,480,TP53,974,1101,127,23,1.35294117647,1.83044982699
454,479,TP53,973,1066,93,23,1.35294117647,1.83044982699
455,476,TP53,960,1066,106,27,1.35,1.8225
456,4,TP53,145,289,144,51,1.34210526316,1.8012465374
457,478,TP53,973,1066,93,24,1.33333333333,1.77777777778
458,475,TP53,958,1066,108,28,1.33333333333,1.77777777778
459,25,TP53,217,359,142,57,1.32558139535,1.75716603569
460,24,TP53,217,359,142,58,1.31818181818,1.73760330579
461,474,TP53,957,1066,109,29,1.31818181818,1.73760330579
462,6,TP53,154,300,146,50,1.31578947368,1.73130193906
463,23,TP53,215,359,144,59,1.31111111111,1.71901234568
464,26,TP53,222,359,137,55,1.30952380952,1.71485260771
465,5,TP53,153,300,147,51,1.30769230769,1.7100591716
466,27,TP53,229,376,147,64,1.30612244898,1.70595585173
467,472,TP53,950,1057,107,30,1.30434782609,1.70132325142
468,473,TP53,955,1066,111,30,1.30434782609,1.70132325142
469,15,TP53,184,332,148,56,1.3023255814,1.69605191996
470,16,TP53,186,333,147,55,1.27906976744,1.63601946998
471,7,TP53,156,300,144,47,1.27027027027,1.61358655953
472,8,TP53,162,310,148,49,1.25641025641,1.57856673241
473,10,TP53,166,314,148,49,1.25641025641,1.57856673241
474,486,TP53,994,1123,129,15,1.25,1.5625
475,17,TP53,193,339,146,55,1.25,1.5625
476,9,TP53,166,314,148,50,1.25,1.5625
477,11,TP53,173,321,148,51,1.24390243902,1.54729327781
478,13,TP53,176,323,147,51,1.24390243902,1.54729327781
479,14,TP53,182,329,147,52,1.2380952381,1.53287981859
480,12,TP53,175,323,148,52,1.2380952381,1.53287981859
481,485,TP53,993,1123,130,16,1.23076923077,1.51479289941
482,22,TP53,214,358,144,55,1.22222222222,1.49382716049
483,21,TP53,210,358,148,56,1.21739130435,1.4820415879
484,20,TP53,201,343,142,52,1.20930232558,1.46241211466
485,19,TP53,200,339,139,52,1.20930232558,1.46241211466
486,18,TP53,199,339,140,53,1.20454545455,1.45092975207
